 NO test1.xpm

SO test2.xpm


WE test3.xpm

EA tes4.xpm



F 220,100,8   



C 89,30,8 
                
                
                   
        11111111111 1111111111111
        1000000000110000000000001
        1011000001110000000000001
        1001000000000000000000001
111111111011000001110000000000001
100000000011000001110111111111111
111111111111111111111111111111111111
11111111111111111111111111111111111111
11110111111111011100000010001
11110111111111011101010010001
11000000110101011100000010001
10000000000000001100000010001
10000000000000001101010010001
1000001110101011111011N100111
11110111 1110101 101111010001
1111111 1111111 111111111111


 




  
  