 
 

 C 35,19,73
F 15,6,40

 NO test1.xpm

SO test2.xpm


WE test3.xpm

EA tes4.xpm

11111
10001
10S01
10001
10001
100011111
 111010001
10001
10001
10001
10001
10001
11111

  




  
   

    