   1111111111111111111111111        
100000000011010000000000001  
1011000001110000001111101  
100100000000000000011111111   
1111111110110000011000000010001111111
10000000001100000111111101111111   
1111011111111101110000001001
  11110111111111011100010010001
100000011010101110000001001
1000000000000000110000010001
10000000000000001101010000001
11000001110101011111011110N0011
11110111011101010101111010000001
    11111111111111111111111111111111111