 
 

 C 35,19,73
F 15,6,7

 NO ../test1.xpm

SO test2.xpm


WE test3.xpm

EA tes4.xpm

1111111111111111 11
11110011
1N1011
1001
10001
10001111111
 111010001
1000111111
10001
10001
10001
10001
11111