
1111111111111111111111111
1000000000110000000000001
11111111111111111111111111
111111111111111111111111111111111
111111111011000001110000000000001
100000000011000001110111111111111
11110111111111011100000010001
11110111111111011101010010001
1100000011010101110000010001     111111111111111
10000000000000001100000010001   11111111
1000000000000000110101001111    111100111
11000001110101011111011110N0111 1111111111
11111111 1111111 111111111111   111111111111