 NO test1

SO test2


WE test3



EA test4









F 220,100,7










C 89,30,8


111
101
101
101
111111
11111
101
101
101
101
101
101
101
1S1
111
