 NO test1.xpm

SO test2.xpm


WE test3.xpm

EA tes4.xpm


                
                
F 18,53,25
C 153,204,255

11111111
   111111              
1111N1
1
1
1
1
1









