   111111111 1111111111111111      111111111 1111111111111111     
100000000011010000000000001  
1011000001110000001111101  111111111 1111111111111111
100100000000000000011111111   111111111 1111111111111111
11111111101100000110000000100001111111
10000000001100000111111101111111   111111111 1111111111111111
1111011111111101110000001001
  11110111111111011100010010001
100000011010101110000001001
10000000000000001100000111                     1
10000000000000001101011111111101
11000001110101011111011110N0011
11110111011101010101111010000001
    1111111111111111   1111111111111111111
  