1111111111111111111111111
1000000000110000000000001
1011000001110000001111101
1001000000000000000111111
11111111101100000110000000010001
10000000001100000111111101111111   
11110111111111011100000010001    
11110111111111011100010010001
11000000110101011100000010001
10000000000000001100000010001
1000000000000000110101000101
1100000111010101111101111VkV111
11110111 1110101 10111101VVV1
11111111 1111111 111111111111
